%%%%%%%%%%%%%%%%%%%%%%%%%%%%%%%%%%%%%
%       % % %           %   %     % %
% %%%%%%% % %%% % %%% %%% %%%%%%% % %
%       %       % %     %     % %   %
%%%%% %%%%% %%% % % % %%% %%%%% % %%%
%   % % % %   % % % %   % %   % %   %
% %%% % % % %%% %%%%% %%% % %%% %%% %
%       %     %   %   %     % % %   %
%%% %%%%%%%%% %%%%%%% %%% %%% % % % %
%             %       % %   %     % %
% % %%%%% % %%% % % %%% % %%% %%% % %
% % %     % % % % %     %   % % % % %
% % % %%%%%%% % %%%%%%%%% %%% % %%% %
% % % %  .  %   %     %     %   %   %
%%% %%% % %%%%% %%%%% %%% %%% %%%%% %
%     % % %     % %     % %   % % % %
% % % % % %%% %%% %%% %%% % % % % % %
% % % % %   .       .     % % %     %
%%% %%%%%%% % % %%%%% %%% % %%% %%%%%
%       % % % %     %   %     % %   %
%%%%% % % %%%%%%%%% %%%%%%%%%%% % %%%
%   % %         . % %     %   % %   %
% %%% %%%%% %%%%%%%%% %%%%% % % %%% %
% %   %      %    .   %     %       %
% % % %%%%% %%% % % % % %%%%%%%%%%%%%
% % %   %     % % % %       %   % % %
% % %%% %%% % % % %%%%%%%%% %%% % % %
% %   % %   % % %   % %   % % %  .  %
% %%% %%% %%%%% %%% % % %%%%% % %%%%%
%       %   %     % %     %   % %   %
%%% % %%%%% %%%%% %%% %%% % %%% % %%%
% % % % % % % %     % %   % %   % % %
% % %%% % % % % %%%%%%%%% % % % % % %
%   %   %   %     .        .  %     %
% % % % %%% %%% %%%%%%% %%% %%% %%% %
%.% % %       %   %       % . % %  P%
%%%%%%%%%%%%%%%%%%%%%%%%%%%%%%%%%%%%%